###########################
#                         #
#                         #
#                         #
#                         #
#                         #
#      ##                 #
#      ##                 #
#                         #
#                         #
#                         #
#                         #
#                         #
#                         #
###########################